    //////
    //   /
    //$  /
  ////  $//
  //  $ $ /
//// # ## /   ///////////////////////
//   # ## /////                   ../
// $  $                    #      ../
////// ### #@##  ..#      #         /
    //     //////////////////////////
    ////////