    ######
    ##   #
    ##   #
  ####   ##
  ##      #
#### # ## #   #   ####
##   # ## #### $  $..#
##               $$..#
###### ### #@  $  $..#
    ##     ###########
    ########