#########       #
        #       #
        #       #
########@########
#       #
#       #
#       #########       